. . . . # # # . . # # # . . . .
. . . . # # # . . . . . . . . .
. . . . # # # . . . . . . . . .
a . . a # # # . . # # # . . . .
a . . a # # # . . # # # e . . e
. . . . # # # . . # # # e . . e
. . . . . . . . . # # # . . . .
. . . . . . . . . # # # . . . .
. . . . # # # . . # # # . . . .