. . . . . . . . . . . . . . . .
. . . . . . . . . . . . . . . .
. . . . . . . . . . . . . . . .
a a a . ~ ~ ~ . . . . . . . . .
a a a . ~ ~ ~ . . . ~ ~ ~ . e e
a a a . ~ ~ ~ . . . ~ ~ ~ . e e
. . . . . . . . . . ~ ~ ~ . e e
. . . . . . . . . . ~ ~ ~ . e e
. . . . . . . . . . ~ ~ ~ . . .
