. . # # # # # # # # # # # # . .
a a # # # . # # # # . # # # e e
. . # # # . . . . . . # # # . .
. . . . . . . . . . . . . . . .
. . . . . . . . . . . . . . . .
. . # # # . ~ . . ~ . # # # . .
a a # # # . ~ . . ~ . # # # e e
. . # # # . . . . . . # # # . .
. . # # # . . . . . . # # # . .