. . . . . . . . . . . . . . . . . . . .
. . . . . . . . . . . . . . . . . . . .
. . . . . . . . . . . . . . . . . . . .
. . . . ~ ~ ~ . . . . . . . . . . . . .
. . . . ~ ~ ~ . . . ~ ~ ~ ~ ~ ~ . . . .
. . . . ~ ~ ~ . . . ~ ~ ~ ~ ~ ~ . . . .
. . . . . . . . . . ~ ~ ~ ~ ~ ~ . . . .
. . . . . . . . . . ~ ~ ~ ~ ~ ~ . . . .
. . . . . . . . . . ~ ~ ~ ~ ~ ~ . . . .
. . . . . . . . . . ~ ~ ~ ~ ~ ~ . . . .