. . . . . . . . . . . . . . . .
. . . . . . . . . . . . . . . .
a . . . . . . . . . . . . . . .
a . . . ~ ~ ~ . . . . . . . . .
. . . . ~ ~ ~ . . . ~ ~ ~ . . .
a . . . ~ ~ ~ . . . ~ ~ ~ e . e
a . . . . . . . . . ~ ~ ~ e . e
. . . . . . . . . . ~ ~ ~ . . .
. . . . . . . . . . ~ ~ ~ . . .
